WWWWWWWWWWWWW
W   X       W
W XXX XXXX XW
W     X    XW
WXXXXXX XX XW
W       X   W
WX XXXXXXXX W
W       XX  W
WXXXXXX X  XW
W    X  XX XW
W XX X XX   W
W  X   X  X W
WWSWWWWWWWWWW
