WWWWWWWWWWWWWW
W X X       XW
W     XXXXX  W
W XXXXX   XX W
W  X    X    W
WX X XXXXXXX W
WX X      XX W
W  X XXXX  XXW
WX XXXX XX   W
W   XX   XXX W
WXX    XXXX  W
W X XXXX    XW
W   X    XX  W
WWWWWSWWWWWWWW
