WWWWWWWWW
WX   X XW
W  X X  W
W XX XX W
W X   X W
W XXX X W
W  XX X W
WX  X   W
WWWSWWWWW
