WWWWWW
W    W
WX XXW
W    W
W X XW
WWWSWW
